Game,Date,Tm,PTS,CUMPTS,Champs
1,10/29/03,CLE,25,25,0
2,10/30/03,CLE,21,46,0
3,11/1/03,CLE,8,54,0
4,11/5/03,CLE,7,61,0
5,11/7/03,CLE,23,84,0
6,11/8/03,CLE,17,101,0
7,11/10/03,CLE,17,118,0
8,11/12/03,CLE,18,136,0
9,11/14/03,CLE,10,146,0
10,11/15/03,CLE,22,168,0
11,11/18/03,CLE,14,182,0
12,11/19/03,CLE,28,210,0
13,11/21/03,CLE,19,229,0
14,11/22/03,CLE,15,244,0
15,11/26/03,CLE,15,259,0
16,11/28/03,CLE,6,265,0
17,11/29/03,CLE,33,298,0
18,12/2/03,CLE,19,317,0
19,12/3/03,CLE,4,321,0
20,12/6/03,CLE,8,329,0
21,12/9/03,CLE,18,347,0
22,12/11/03,CLE,23,370,0
23,12/13/03,CLE,37,407,0
24,12/15/03,CLE,27,434,0
25,12/17/03,CLE,17,451,0
26,12/19/03,CLE,36,487,0
27,12/20/03,CLE,32,519,0
28,12/23/03,CLE,22,541,0
29,12/25/03,CLE,34,575,0
30,12/26/03,CLE,18,593,0
31,12/28/03,CLE,32,625,0
32,12/30/03,CLE,22,647,0
33,1/2/04,CLE,14,661,0
34,1/6/04,CLE,14,675,0
35,1/7/04,CLE,21,696,0
36,1/9/04,CLE,19,715,0
37,1/12/04,CLE,16,731,0
38,1/13/04,CLE,27,758,0
39,1/15/04,CLE,29,787,0
40,1/17/04,CLE,29,816,0
41,1/26/04,CLE,16,832,0
42,1/28/04,CLE,27,859,0
43,1/30/04,CLE,20,879,0
44,2/1/04,CLE,38,917,0
45,2/3/04,CLE,12,929,0
46,2/4/04,CLE,32,961,0
47,2/6/04,CLE,14,975,0
48,2/7/04,CLE,14,989,0
49,2/9/04,CLE,24,1013,0
50,2/11/04,CLE,9,1022,0
51,2/18/04,CLE,16,1038,0
52,2/20/04,CLE,32,1070,0
53,2/22/04,CLE,22,1092,0
54,2/23/04,CLE,21,1113,0
55,2/25/04,CLE,11,1124,0
56,2/27/04,CLE,30,1154,0
57,3/1/04,CLE,18,1172,0
58,3/3/04,CLE,24,1196,0
59,3/5/04,CLE,19,1215,0
60,3/6/04,CLE,24,1239,0
61,3/8/04,CLE,34,1273,0
62,3/10/04,CLE,14,1287,0
63,3/14/04,CLE,26,1313,0
64,3/16/04,CLE,17,1330,0
65,3/19/04,CLE,14,1344,0
66,3/21/04,CLE,15,1359,0
67,3/23/04,CLE,25,1384,0
68,3/26/04,CLE,16,1400,0
69,3/27/04,CLE,41,1441,0
70,3/29/04,CLE,18,1459,0
71,3/30/04,CLE,28,1487,0
72,4/2/04,CLE,20,1507,0
73,4/3/04,CLE,34,1541,0
74,4/6/04,CLE,21,1562,0
75,4/7/04,CLE,14,1576,0
76,4/9/04,CLE,24,1600,0
77,4/10/04,CLE,10,1610,0
78,4/12/04,CLE,27,1637,0
79,4/14/04,CLE,17,1654,0
80,11/3/04,CLE,28,1682,0
81,11/4/04,CLE,21,1703,0
82,11/6/04,CLE,31,1734,0
83,11/9/04,CLE,25,1759,0
84,11/10/04,CLE,38,1797,0
85,11/13/04,CLE,24,1821,0
86,11/15/04,CLE,33,1854,0
87,11/18/04,CLE,19,1873,0
88,11/20/04,CLE,25,1898,0
89,11/21/04,CLE,13,1911,0
90,11/24/04,CLE,43,1954,0
91,11/26/04,CLE,20,1974,0
92,11/27/04,CLE,26,2000,0
93,11/29/04,CLE,22,2022,0
94,12/1/04,CLE,15,2037,0
95,12/2/04,CLE,17,2054,0
96,12/4/04,CLE,27,2081,0
97,12/7/04,CLE,27,2108,0
98,12/8/04,CLE,19,2127,0
99,12/11/04,CLE,23,2150,0
100,12/13/04,CLE,31,2181,0
101,12/15/04,CLE,25,2206,0
102,12/16/04,CLE,11,2217,0
103,12/18/04,CLE,31,2248,0
104,12/21/04,CLE,26,2274,0
105,12/22/04,CLE,23,2297,0
106,12/26/04,CLE,22,2319,0
107,12/28/04,CLE,40,2359,0
108,12/29/04,CLE,3,2362,0
109,1/3/05,CLE,26,2388,0
110,1/5/05,CLE,20,2408,0
111,1/8/05,CLE,22,2430,0
112,1/11/05,CLE,29,2459,0
113,1/13/05,CLE,28,2487,0
114,1/15/05,CLE,27,2514,0
115,1/16/05,CLE,35,2549,0
116,1/19/05,CLE,27,2576,0
117,1/20/05,CLE,18,2594,0
118,1/22/05,CLE,28,2622,0
119,1/24/05,CLE,31,2653,0
120,1/26/05,CLE,27,2680,0
121,2/1/05,CLE,28,2708,0
122,2/3/05,CLE,31,2739,0
123,2/5/05,CLE,30,2769,0
124,2/8/05,CLE,15,2784,0
125,2/11/05,CLE,35,2819,0
126,2/13/05,CLE,25,2844,0
127,2/16/05,CLE,28,2872,0
128,2/17/05,CLE,26,2898,0
129,2/23/05,CLE,27,2925,0
130,2/25/05,CLE,21,2946,0
131,2/27/05,CLE,28,2974,0
132,2/28/05,CLE,20,2994,0
133,3/2/05,CLE,32,3026,0
134,3/4/05,CLE,34,3060,0
135,3/6/05,CLE,23,3083,0
136,3/8/05,CLE,23,3106,0
137,3/13/05,CLE,35,3141,0
138,3/15/05,CLE,36,3177,0
139,3/16/05,CLE,34,3211,0
140,3/18/05,CLE,16,3227,0
141,3/20/05,CLE,56,3283,0
142,3/22/05,CLE,29,3312,0
143,3/24/05,CLE,19,3331,0
144,3/26/05,CLE,19,3350,0
145,3/28/05,CLE,44,3394,0
146,3/29/05,CLE,22,3416,0
147,3/31/05,CLE,26,3442,0
148,4/1/05,CLE,35,3477,0
149,4/3/05,CLE,37,3514,0
150,4/5/05,CLE,24,3538,0
151,4/6/05,CLE,20,3558,0
152,4/8/05,CLE,37,3595,0
153,4/9/05,CLE,40,3635,0
154,4/11/05,CLE,33,3668,0
155,4/14/05,CLE,27,3695,0
156,4/15/05,CLE,38,3733,0
157,4/17/05,CLE,37,3770,0
158,4/19/05,CLE,32,3802,0
159,4/20/05,CLE,27,3829,0
160,11/2/05,CLE,31,3860,0
161,11/4/05,CLE,20,3880,0
162,11/5/05,CLE,36,3916,0
163,11/7/05,CLE,27,3943,0
164,11/9/05,CLE,31,3974,0
165,11/11/05,CLE,16,3990,0
166,11/13/05,CLE,26,4016,0
167,11/15/05,CLE,37,4053,0
168,11/18/05,CLE,16,4069,0
169,11/19/05,CLE,36,4105,0
170,11/22/05,CLE,36,4141,0
171,11/24/05,CLE,19,4160,0
172,11/26/05,CLE,38,4198,0
173,11/30/05,CLE,28,4226,0
174,12/2/05,CLE,34,4260,0
175,12/3/05,CLE,30,4290,0
176,12/6/05,CLE,30,4320,0
177,12/9/05,CLE,32,4352,0
178,12/10/05,CLE,52,4404,0
179,12/13/05,CLE,39,4443,0
180,12/15/05,CLE,26,4469,0
181,12/17/05,CLE,41,4510,0
182,12/20/05,CLE,25,4535,0
183,12/22/05,CLE,37,4572,0
184,12/23/05,CLE,14,4586,0
185,12/26/05,CLE,32,4618,0
186,12/27/05,CLE,31,4649,0
187,12/31/05,CLE,30,4679,0
188,1/4/06,CLE,32,4711,0
189,1/5/06,CLE,32,4743,0
190,1/7/06,CLE,35,4778,0
191,1/10/06,CLE,36,4814,0
192,1/12/06,CLE,28,4842,0
193,1/14/06,CLE,46,4888,0
194,1/15/06,CLE,29,4917,0
195,1/18/06,CLE,24,4941,0
196,1/20/06,CLE,14,4955,0
197,1/21/06,CLE,51,5006,0
198,1/24/06,CLE,23,5029,0
199,1/25/06,CLE,38,5067,0
200,1/27/06,CLE,30,5097,0
201,1/29/06,CLE,44,5141,0
202,1/30/06,CLE,30,5171,0
203,2/1/06,CLE,26,5197,0
204,2/2/06,CLE,29,5226,0
205,2/4/06,CLE,31,5257,0
206,2/6/06,CLE,22,5279,0
207,2/8/06,CLE,35,5314,0
208,2/10/06,CLE,18,5332,0
209,2/11/06,CLE,33,5365,0
210,2/13/06,CLE,44,5409,0
211,2/15/06,CLE,43,5452,0
212,2/21/06,CLE,26,5478,0
213,2/22/06,CLE,33,5511,0
214,2/24/06,CLE,25,5536,0
215,2/26/06,CLE,22,5558,0
216,2/27/06,CLE,26,5584,0
217,3/1/06,CLE,19,5603,0
218,3/2/06,CLE,33,5636,0
219,3/5/06,CLE,37,5673,0
220,3/7/06,CLE,17,5690,0
221,3/8/06,CLE,35,5725,0
222,3/10/06,CLE,25,5750,0
223,3/12/06,CLE,47,5797,0
224,3/14/06,CLE,36,5833,0
225,3/17/06,CLE,27,5860,0
226,3/19/06,CLE,29,5889,0
227,3/22/06,CLE,37,5926,0
228,3/24/06,CLE,36,5962,0
229,3/26/06,CLE,36,5998,0
230,3/29/06,CLE,46,6044,0
231,4/1/06,CLE,47,6091,0
232,4/2/06,CLE,35,6126,0
233,4/4/06,CLE,37,6163,0
234,4/5/06,CLE,36,6199,0
235,4/8/06,CLE,37,6236,0
236,4/10/06,CLE,32,6268,0
237,4/12/06,CLE,22,6290,0
238,4/16/06,CLE,17,6307,0
239,11/1/06,CLE,26,6333,0
240,11/3/06,CLE,35,6368,0
241,11/4/06,CLE,16,6384,0
242,11/7/06,CLE,34,6418,0
243,11/9/06,CLE,19,6437,0
244,11/11/06,CLE,38,6475,0
245,11/13/06,CLE,29,6504,0
246,11/15/06,CLE,32,6536,0
247,11/17/06,CLE,37,6573,0
248,11/18/06,CLE,20,6593,0
249,11/21/06,CLE,15,6608,0
250,11/22/06,CLE,30,6638,0
251,11/24/06,CLE,30,6668,0
252,11/25/06,CLE,25,6693,0
253,11/29/06,CLE,27,6720,0
254,12/1/06,CLE,31,6751,0
255,12/2/06,CLE,21,6772,0
256,12/6/06,CLE,26,6798,0
257,12/9/06,CLE,27,6825,0
258,12/11/06,CLE,15,6840,0
259,12/13/06,CLE,22,6862,0
260,12/15/06,CLE,22,6884,0
261,12/16/06,CLE,29,6913,0
262,12/20/06,CLE,37,6950,0
263,12/21/06,CLE,26,6976,0
264,12/23/06,CLE,32,7008,0
265,12/27/06,CLE,27,7035,0
266,12/29/06,CLE,32,7067,0
267,12/30/06,CLE,33,7100,0
268,1/2/07,CLE,19,7119,0
269,1/3/07,CLE,32,7151,0
270,1/5/07,CLE,8,7159,0
271,1/6/07,CLE,19,7178,0
272,1/9/07,CLE,34,7212,0
273,1/11/07,CLE,34,7246,0
274,1/13/07,CLE,28,7274,0
275,1/16/07,CLE,30,7304,0
276,1/17/07,CLE,23,7327,0
277,1/19/07,CLE,30,7357,0
278,1/20/07,CLE,32,7389,0
279,1/22/07,CLE,18,7407,0
280,1/24/07,CLE,39,7446,0
281,1/28/07,CLE,30,7476,0
282,2/1/07,CLE,17,7493,0
283,2/2/07,CLE,18,7511,0
284,2/4/07,CLE,21,7532,0
285,2/7/07,CLE,11,7543,0
286,2/9/07,CLE,29,7572,0
287,2/11/07,CLE,18,7590,0
288,2/14/07,CLE,23,7613,0
289,2/15/07,CLE,38,7651,0
290,2/21/07,CLE,29,7680,0
291,2/22/07,CLE,29,7709,0
292,2/25/07,CLE,29,7738,0
293,2/27/07,CLE,35,7773,0
294,3/1/07,CLE,39,7812,0
295,3/3/07,CLE,36,7848,0
296,3/5/07,CLE,32,7880,0
297,3/7/07,CLE,41,7921,0
298,3/10/07,CLE,32,7953,0
299,3/11/07,CLE,26,7979,0
300,3/14/07,CLE,29,8008,0
301,3/17/07,CLE,24,8032,0
302,3/20/07,CLE,37,8069,0
303,3/21/07,CLE,31,8100,0
304,3/23/07,CLE,21,8121,0
305,3/25/07,CLE,18,8139,0
306,3/27/07,CLE,26,8165,0
307,3/28/07,CLE,24,8189,0
308,3/31/07,CLE,39,8228,0
309,4/3/07,CLE,31,8259,0
310,4/5/07,CLE,35,8294,0
311,4/6/07,CLE,25,8319,0
312,4/8/07,CLE,20,8339,0
313,4/12/07,CLE,35,8374,0
314,4/14/07,CLE,23,8397,0
315,4/17/07,CLE,18,8415,0
316,4/18/07,CLE,24,8439,0
317,10/31/07,CLE,10,8449,0
318,11/2/07,CLE,45,8494,0
319,11/4/07,CLE,27,8521,0
320,11/6/07,CLE,24,8545,0
321,11/7/07,CLE,32,8577,0
322,11/9/07,CLE,26,8603,0
323,11/11/07,CLE,22,8625,0
324,11/12/07,CLE,27,8652,0
325,11/14/07,CLE,39,8691,0
326,11/16/07,CLE,40,8731,0
327,11/20/07,CLE,34,8765,0
328,11/21/07,CLE,45,8810,0
329,11/24/07,CLE,37,8847,0
330,11/25/07,CLE,30,8877,0
331,11/27/07,CLE,38,8915,0
332,11/28/07,CLE,15,8930,0
333,12/11/07,CLE,17,8947,0
334,12/14/07,CLE,29,8976,0
335,12/15/07,CLE,21,8997,0
336,12/17/07,CLE,31,9028,0
337,12/19/07,CLE,32,9060,0
338,12/20/07,CLE,33,9093,0
339,12/23/07,CLE,25,9118,0
340,12/25/07,CLE,25,9143,0
341,12/27/07,CLE,24,9167,0
342,12/29/07,CLE,21,9188,0
343,1/2/08,CLE,36,9224,0
344,1/4/08,CLE,24,9248,0
345,1/6/08,CLE,39,9287,0
346,1/8/08,CLE,22,9309,0
347,1/9/08,CLE,31,9340,0
348,1/11/08,CLE,31,9371,0
349,1/15/08,CLE,51,9422,0
350,1/17/08,CLE,27,9449,0
351,1/21/08,CLE,28,9477,0
352,1/23/08,CLE,23,9500,0
353,1/25/08,CLE,36,9536,0
354,1/27/08,CLE,41,9577,0
355,1/30/08,CLE,37,9614,0
356,2/2/08,CLE,28,9642,0
357,2/5/08,CLE,33,9675,0
358,2/7/08,CLE,32,9707,0
359,2/8/08,CLE,26,9733,0
360,2/10/08,CLE,30,9763,0
361,2/11/08,CLE,29,9792,0
362,2/13/08,CLE,39,9831,0
363,2/19/08,CLE,26,9857,0
364,2/20/08,CLE,31,9888,0
365,2/22/08,CLE,33,9921,0
366,2/24/08,CLE,25,9946,0
367,2/26/08,CLE,35,9981,0
368,2/27/08,CLE,26,10007,0
369,2/29/08,CLE,30,10037,0
370,3/2/08,CLE,37,10074,0
371,3/5/08,CLE,50,10124,0
372,3/6/08,CLE,39,10163,0
373,3/8/08,CLE,38,10201,0
374,3/10/08,CLE,24,10225,0
375,3/12/08,CLE,42,10267,0
376,3/13/08,CLE,25,10292,0
377,3/16/08,CLE,33,10325,0
378,3/17/08,CLE,30,10355,0
379,3/19/08,CLE,30,10385,0
380,3/21/08,CLE,29,10414,0
381,3/22/08,CLE,29,10443,0
382,3/26/08,CLE,21,10464,0
383,3/29/08,CLE,13,10477,0
384,3/30/08,CLE,26,10503,0
385,4/2/08,CLE,29,10532,0
386,4/3/08,CLE,33,10565,0
387,4/5/08,CLE,17,10582,0
388,4/9/08,CLE,33,10615,0
389,4/11/08,CLE,34,10649,0
390,4/13/08,CLE,13,10662,0
391,4/14/08,CLE,27,10689,0
392,10/28/08,CLE,22,10711,0
393,10/30/08,CLE,22,10733,0
394,11/1/08,CLE,15,10748,0
395,11/3/08,CLE,29,10777,0
396,11/5/08,CLE,41,10818,0
397,11/7/08,CLE,27,10845,0
398,11/8/08,CLE,41,10886,0
399,11/11/08,CLE,41,10927,0
400,11/13/08,CLE,22,10949,0
401,11/15/08,CLE,38,10987,0
402,11/18/08,CLE,31,11018,0
403,11/19/08,CLE,25,11043,0
404,11/22/08,CLE,24,11067,0
405,11/25/08,CLE,26,11093,0
406,11/26/08,CLE,14,11107,0
407,11/28/08,CLE,23,11130,0
408,11/29/08,CLE,32,11162,0
409,12/3/08,CLE,21,11183,0
410,12/5/08,CLE,11,11194,0
411,12/6/08,CLE,25,11219,0
412,12/9/08,CLE,31,11250,0
413,12/10/08,CLE,29,11279,0
414,12/12/08,CLE,28,11307,0
415,12/13/08,CLE,33,11340,0
416,12/17/08,CLE,32,11372,0
417,12/19/08,CLE,33,11405,0
418,12/21/08,CLE,31,11436,0
419,12/23/08,CLE,27,11463,0
420,12/25/08,CLE,18,11481,0
421,12/28/08,CLE,33,11514,0
422,12/30/08,CLE,38,11552,0
423,1/2/09,CLE,16,11568,0
424,1/4/09,CLE,30,11598,0
425,1/7/09,CLE,21,11619,0
426,1/9/09,CLE,38,11657,0
427,1/13/09,CLE,30,11687,0
428,1/15/09,CLE,28,11715,0
429,1/16/09,CLE,29,11744,0
430,1/19/09,CLE,23,11767,0
431,1/21/09,CLE,34,11801,0
432,1/23/09,CLE,32,11833,0
433,1/24/09,CLE,33,11866,0
434,1/27/09,CLE,23,11889,0
435,1/29/09,CLE,23,11912,0
436,1/30/09,CLE,25,11937,0
437,2/1/09,CLE,33,11970,0
438,2/3/09,CLE,33,12003,0
439,2/4/09,CLE,52,12055,0
440,2/8/09,CLE,16,12071,0
441,2/10/09,CLE,47,12118,0
442,2/11/09,CLE,26,12144,0
443,2/18/09,CLE,20,12164,0
444,2/20/09,CLE,55,12219,0
445,2/22/09,CLE,20,12239,0
446,2/24/09,CLE,15,12254,0
447,2/26/09,CLE,21,12275,0
448,2/27/09,CLE,30,12305,0
449,3/1/09,CLE,26,12331,0
450,3/2/09,CLE,42,12373,0
451,3/4/09,CLE,23,12396,0
452,3/6/09,CLE,21,12417,0
453,3/7/09,CLE,14,12431,0
454,3/10/09,CLE,32,12463,0
455,3/12/09,CLE,34,12497,0
456,3/13/09,CLE,51,12548,0
457,3/15/09,CLE,19,12567,0
458,3/17/09,CLE,43,12610,0
459,3/19/09,CLE,26,12636,0
460,3/21/09,CLE,22,12658,0
461,3/22/09,CLE,30,12688,0
462,3/25/09,CLE,22,12710,0
463,3/27/09,CLE,25,12735,0
464,3/29/09,CLE,24,12759,0
465,3/31/09,CLE,25,12784,0
466,4/2/09,CLE,31,12815,0
467,4/3/09,CLE,26,12841,0
468,4/5/09,CLE,38,12879,0
469,4/8/09,CLE,21,12900,0
470,4/10/09,CLE,27,12927,0
471,4/12/09,CLE,29,12956,0
472,4/13/09,CLE,37,12993,0
473,10/27/09,CLE,38,13031,0
474,10/28/09,CLE,23,13054,0
475,10/30/09,CLE,24,13078,0
476,10/31/09,CLE,14,13092,0
477,11/3/09,CLE,27,13119,0
478,11/5/09,CLE,25,13144,0
479,11/6/09,CLE,33,13177,0
480,11/11/09,CLE,36,13213,0
481,11/12/09,CLE,34,13247,0
482,11/14/09,CLE,21,13268,0
483,11/17/09,CLE,31,13299,0
484,11/18/09,CLE,34,13333,0
485,11/20/09,CLE,40,13373,0
486,11/21/09,CLE,32,13405,0
487,11/25/09,CLE,34,13439,0
488,11/27/09,CLE,25,13464,0
489,11/28/09,CLE,25,13489,0
490,12/2/09,CLE,12,13501,0
491,12/4/09,CLE,23,13524,0
492,12/6/09,CLE,14,13538,0
493,12/8/09,CLE,43,13581,0
494,12/9/09,CLE,27,13608,0
495,12/11/09,CLE,33,13641,0
496,12/13/09,CLE,44,13685,0
497,12/15/09,CLE,23,13708,0
498,12/16/09,CLE,36,13744,0
499,12/18/09,CLE,26,13770,0
500,12/20/09,CLE,25,13795,0
501,12/21/09,CLE,29,13824,0
502,12/23/09,CLE,34,13858,0
503,12/25/09,CLE,26,13884,0
504,12/27/09,CLE,29,13913,0
505,12/29/09,CLE,14,13927,0
506,12/30/09,CLE,48,13975,0
507,1/2/10,CLE,28,14003,0
508,1/3/10,CLE,29,14032,0
509,1/6/10,CLE,23,14055,0
510,1/8/10,CLE,35,14090,0
511,1/10/10,CLE,41,14131,0
512,1/11/10,CLE,37,14168,0
513,1/14/10,CLE,36,14204,0
514,1/16/10,CLE,32,14236,0
515,1/19/10,CLE,28,14264,0
516,1/21/10,CLE,37,14301,0
517,1/23/10,CLE,37,14338,0
518,1/25/10,CLE,32,14370,0
519,1/27/10,CLE,12,14382,0
520,1/29/10,CLE,22,14404,0
521,1/31/10,CLE,32,14436,0
522,2/2/10,CLE,22,14458,0
523,2/4/10,CLE,36,14494,0
524,2/6/10,CLE,47,14541,0
525,2/9/10,CLE,32,14573,0
526,2/11/10,CLE,32,14605,0
527,2/18/10,CLE,43,14648,0
528,2/19/10,CLE,22,14670,0
529,2/21/10,CLE,33,14703,0
530,2/23/10,CLE,20,14723,0
531,2/25/10,CLE,36,14759,0
532,2/26/10,CLE,36,14795,0
533,3/1/10,CLE,22,14817,0
534,3/3/10,CLE,26,14843,0
535,3/5/10,CLE,40,14883,0
536,3/12/10,CLE,23,14906,0
537,3/14/10,CLE,30,14936,0
538,3/16/10,CLE,29,14965,0
539,3/17/10,CLE,32,14997,0
540,3/19/10,CLE,29,15026,0
541,3/21/10,CLE,15,15041,0
542,3/24/10,CLE,38,15079,0
543,3/26/10,CLE,27,15106,0
544,3/28/10,CLE,34,15140,0
545,3/31/10,CLE,23,15163,0
546,4/2/10,CLE,27,15190,0
547,4/4/10,CLE,42,15232,0
548,4/6/10,CLE,19,15251,0
549,10/26/10,MIA,31,15282,0
550,10/27/10,MIA,16,15298,0
551,10/29/10,MIA,15,15313,0
552,10/31/10,MIA,20,15333,0
553,11/2/10,MIA,20,15353,0
554,11/5/10,MIA,20,15373,0
555,11/6/10,MIA,23,15396,0
556,11/9/10,MIA,20,15416,0
557,11/11/10,MIA,35,15451,0
558,11/13/10,MIA,23,15474,0
559,11/17/10,MIA,20,15494,0
560,11/19/10,MIA,32,15526,0
561,11/20/10,MIA,29,15555,0
562,11/22/10,MIA,25,15580,0
563,11/24/10,MIA,25,15605,0
564,11/26/10,MIA,20,15625,0
565,11/27/10,MIA,23,15648,0
566,11/29/10,MIA,30,15678,0
567,12/1/10,MIA,18,15696,0
568,12/2/10,MIA,38,15734,0
569,12/4/10,MIA,22,15756,0
570,12/6/10,MIA,17,15773,0
571,12/8/10,MIA,33,15806,0
572,12/10/10,MIA,25,15831,0
573,12/11/10,MIA,25,15856,0
574,12/13/10,MIA,20,15876,0
575,12/15/10,MIA,21,15897,0
576,12/17/10,MIA,32,15929,0
577,12/18/10,MIA,32,15961,0
578,12/20/10,MIA,19,15980,0
579,12/23/10,MIA,36,16016,0
580,12/25/10,MIA,27,16043,0
581,12/28/10,MIA,18,16061,0
582,12/29/10,MIA,20,16081,0
583,1/1/11,MIA,25,16106,0
584,1/3/11,MIA,38,16144,0
585,1/4/11,MIA,25,16169,0
586,1/7/11,MIA,26,16195,0
587,1/9/11,MIA,44,16239,0
588,1/12/11,MIA,27,16266,0
589,1/18/11,MIA,34,16300,0
590,1/22/11,MIA,38,16338,0
591,1/27/11,MIA,24,16362,0
592,1/28/11,MIA,39,16401,0
593,1/30/11,MIA,23,16424,0
594,1/31/11,MIA,24,16448,0
595,2/3/11,MIA,51,16499,0
596,2/4/11,MIA,19,16518,0
597,2/6/11,MIA,12,16530,0
598,2/8/11,MIA,41,16571,0
599,2/11/11,MIA,16,16587,0
600,2/13/11,MIA,22,16609,0
601,2/15/11,MIA,27,16636,0
602,2/16/11,MIA,23,16659,0
603,2/22/11,MIA,31,16690,0
604,2/24/11,MIA,29,16719,0
605,2/25/11,MIA,25,16744,0
606,2/27/11,MIA,27,16771,0
607,3/3/11,MIA,29,16800,0
608,3/4/11,MIA,26,16826,0
609,3/6/11,MIA,26,16852,0
610,3/8/11,MIA,31,16883,0
611,3/10/11,MIA,19,16902,0
612,3/12/11,MIA,27,16929,0
613,3/14/11,MIA,21,16950,0
614,3/16/11,MIA,19,16969,0
615,3/18/11,MIA,43,17012,0
616,3/19/11,MIA,33,17045,0
617,3/23/11,MIA,19,17064,0
618,3/25/11,MIA,32,17096,0
619,3/27/11,MIA,33,17129,0
620,3/29/11,MIA,27,17156,0
621,3/30/11,MIA,35,17191,0
622,4/1/11,MIA,27,17218,0
623,4/3/11,MIA,31,17249,0
624,4/6/11,MIA,29,17278,0
625,4/8/11,MIA,23,17301,0
626,4/10/11,MIA,27,17328,0
627,4/11/11,MIA,34,17362,0
628,12/25/11,MIA,37,17399,0
629,12/27/11,MIA,26,17425,0
630,12/28/11,MIA,35,17460,0
631,12/30/11,MIA,34,17494,0
632,1/1/12,MIA,16,17510,0
633,1/2/12,MIA,28,17538,0
634,1/4/12,MIA,33,17571,0
635,1/7/12,MIA,32,17603,0
636,1/10/12,MIA,26,17629,0
637,1/11/12,MIA,23,17652,0
638,1/13/12,MIA,35,17687,0
639,1/17/12,MIA,33,17720,0
640,1/19/12,MIA,31,17751,0
641,1/21/12,MIA,28,17779,0
642,1/22/12,MIA,28,17807,0
643,1/24/12,MIA,18,17825,0
644,1/25/12,MIA,32,17857,0
645,1/27/12,MIA,31,17888,0
646,1/29/12,MIA,35,17923,0
647,1/30/12,MIA,22,17945,0
648,2/1/12,MIA,40,17985,0
649,2/3/12,MIA,19,18004,0
650,2/5/12,MIA,30,18034,0
651,2/7/12,MIA,24,18058,0
652,2/8/12,MIA,17,18075,0
653,2/10/12,MIA,18,18093,0
654,2/12/12,MIA,23,18116,0
655,2/13/12,MIA,35,18151,0
656,2/14/12,MIA,23,18174,0
657,2/17/12,MIA,28,18202,0
658,2/19/12,MIA,25,18227,0
659,2/21/12,MIA,18,18245,0
660,2/23/12,MIA,20,18265,0
661,3/1/12,MIA,38,18303,0
662,3/2/12,MIA,35,18338,0
663,3/4/12,MIA,25,18363,0
664,3/6/12,MIA,21,18384,0
665,3/7/12,MIA,31,18415,0
666,3/10/12,MIA,27,18442,0
667,3/13/12,MIA,19,18461,0
668,3/14/12,MIA,35,18496,0
669,3/16/12,MIA,29,18525,0
670,3/18/12,MIA,14,18539,0
671,3/20/12,MIA,20,18559,0
672,3/23/12,MIA,17,18576,0
673,3/25/12,MIA,17,18593,0
674,3/26/12,MIA,24,18617,0
675,3/29/12,MIA,19,18636,0
676,3/30/12,MIA,26,18662,0
677,4/1/12,MIA,23,18685,0
678,4/3/12,MIA,41,18726,0
679,4/4/12,MIA,34,18760,0
680,4/6/12,MIA,21,18781,0
681,4/8/12,MIA,26,18807,0
682,4/10/12,MIA,36,18843,0
683,4/12/12,MIA,30,18873,0
684,4/13/12,MIA,19,18892,0
685,4/15/12,MIA,29,18921,0
686,4/16/12,MIA,37,18958,0
687,4/18/12,MIA,28,18986,0
688,4/19/12,MIA,27,19013,0
689,4/22/12,MIA,32,19045,0
690,10/30/12,MIA,26,19071,1
691,11/2/12,MIA,23,19094,1
692,11/3/12,MIA,20,19114,1
693,11/5/12,MIA,23,19137,1
694,11/7/12,MIA,20,19157,1
695,11/9/12,MIA,21,19178,1
696,11/11/12,MIA,20,19198,1
697,11/12/12,MIA,38,19236,1
698,11/14/12,MIA,30,19266,1
699,11/15/12,MIA,27,19293,1
700,11/17/12,MIA,21,19314,1
701,11/21/12,MIA,28,19342,1
702,11/24/12,MIA,30,19372,1
703,11/29/12,MIA,23,19395,1
704,12/1/12,MIA,21,19416,1
705,12/4/12,MIA,26,19442,1
706,12/6/12,MIA,31,19473,1
707,12/8/12,MIA,24,19497,1
708,12/10/12,MIA,27,19524,1
709,12/12/12,MIA,31,19555,1
710,12/15/12,MIA,23,19578,1
711,12/18/12,MIA,22,19600,1
712,12/20/12,MIA,24,19624,1
713,12/22/12,MIA,30,19654,1
714,12/25/12,MIA,29,19683,1
715,12/26/12,MIA,27,19710,1
716,12/28/12,MIA,35,19745,1
717,12/29/12,MIA,26,19771,1
718,12/31/12,MIA,36,19807,1
719,1/2/13,MIA,32,19839,1
720,1/4/13,MIA,30,19869,1
721,1/6/13,MIA,24,19893,1
722,1/8/13,MIA,22,19915,1
723,1/10/13,MIA,15,19930,1
724,1/12/13,MIA,20,19950,1
725,1/14/13,MIA,32,19982,1
726,1/16/13,MIA,25,20007,1
727,1/17/13,MIA,39,20046,1
728,1/23/13,MIA,31,20077,1
729,1/25/13,MIA,23,20100,1
730,1/27/13,MIA,34,20134,1
731,1/30/13,MIA,24,20158,1
732,2/1/13,MIA,28,20186,1
733,2/3/13,MIA,30,20216,1
734,2/4/13,MIA,31,20247,1
735,2/6/13,MIA,32,20279,1
736,2/8/13,MIA,30,20309,1
737,2/10/13,MIA,32,20341,1
738,2/12/13,MIA,30,20371,1
739,2/14/13,MIA,39,20410,1
740,2/20/13,MIA,24,20434,1
741,2/21/13,MIA,26,20460,1
742,2/23/13,MIA,16,20476,1
743,2/24/13,MIA,28,20504,1
744,2/26/13,MIA,40,20544,1
745,3/1/13,MIA,18,20562,1
746,3/3/13,MIA,29,20591,1
747,3/4/13,MIA,20,20611,1
748,3/6/13,MIA,26,20637,1
749,3/8/13,MIA,25,20662,1
750,3/10/13,MIA,13,20675,1
751,3/12/13,MIA,15,20690,1
752,3/13/13,MIA,27,20717,1
753,3/15/13,MIA,28,20745,1
754,3/17/13,MIA,22,20767,1
755,3/18/13,MIA,37,20804,1
756,3/20/13,MIA,25,20829,1
757,3/22/13,MIA,29,20858,1
758,3/24/13,MIA,32,20890,1
759,3/25/13,MIA,24,20914,1
760,3/27/13,MIA,32,20946,1
761,3/29/13,MIA,36,20982,1
762,4/6/13,MIA,27,21009,1
763,4/9/13,MIA,28,21037,1
764,4/12/13,MIA,20,21057,1
765,4/14/13,MIA,24,21081,1
766,10/29/13,MIA,17,21098,2
767,10/30/13,MIA,25,21123,2
768,11/1/13,MIA,26,21149,2
769,11/3/13,MIA,25,21174,2
770,11/5/13,MIA,35,21209,2
771,11/7/13,MIA,18,21227,2
772,11/9/13,MIA,25,21252,2
773,11/12/13,MIA,33,21285,2
774,11/15/13,MIA,39,21324,2
775,11/16/13,MIA,30,21354,2
776,11/19/13,MIA,13,21367,2
777,11/20/13,MIA,21,21388,2
778,11/23/13,MIA,22,21410,2
779,11/25/13,MIA,35,21445,2
780,11/27/13,MIA,28,21473,2
781,11/29/13,MIA,27,21500,2
782,12/1/13,MIA,26,21526,2
783,12/3/13,MIA,23,21549,2
784,12/5/13,MIA,21,21570,2
785,12/7/13,MIA,21,21591,2
786,12/8/13,MIA,24,21615,2
787,12/10/13,MIA,17,21632,2
788,12/14/13,MIA,25,21657,2
789,12/16/13,MIA,30,21687,2
790,12/18/13,MIA,24,21711,2
791,12/20/13,MIA,18,21729,2
792,12/23/13,MIA,38,21767,2
793,12/25/13,MIA,19,21786,2
794,12/27/13,MIA,33,21819,2
795,12/30/13,MIA,26,21845,2
796,1/2/14,MIA,26,21871,2
797,1/4/14,MIA,15,21886,2
798,1/5/14,MIA,30,21916,2
799,1/7/14,MIA,32,21948,2
800,1/9/14,MIA,32,21980,2
801,1/10/14,MIA,36,22016,2
802,1/15/14,MIA,25,22041,2
803,1/17/14,MIA,21,22062,2
804,1/18/14,MIA,34,22096,2
805,1/20/14,MIA,30,22126,2
806,1/21/14,MIA,29,22155,2
807,1/23/14,MIA,27,22182,2
808,1/26/14,MIA,18,22200,2
809,1/29/14,MIA,34,22234,2
810,2/1/14,MIA,30,22264,2
811,2/3/14,MIA,24,22288,2
812,2/5/14,MIA,31,22319,2
813,2/8/14,MIA,13,22332,2
814,2/11/14,MIA,37,22369,2
815,2/12/14,MIA,36,22405,2
816,2/18/14,MIA,42,22447,2
817,2/20/14,MIA,33,22480,2
818,2/27/14,MIA,31,22511,2
819,3/1/14,MIA,20,22531,2
820,3/3/14,MIA,61,22592,2
821,3/4/14,MIA,22,22614,2
822,3/6/14,MIA,19,22633,2
823,3/9/14,MIA,17,22650,2
824,3/10/14,MIA,23,22673,2
825,3/12/14,MIA,19,22692,2
826,3/14/14,MIA,21,22713,2
827,3/16/14,MIA,24,22737,2
828,3/18/14,MIA,43,22780,2
829,3/21/14,MIA,15,22795,2
830,3/22/14,MIA,25,22820,2
831,3/24/14,MIA,32,22852,2
832,3/26/14,MIA,38,22890,2
833,3/28/14,MIA,17,22907,2
834,3/29/14,MIA,13,22920,2
835,3/31/14,MIA,32,22952,2
836,4/2/14,MIA,17,22969,2
837,4/4/14,MIA,34,23003,2
838,4/6/14,MIA,38,23041,2
839,4/8/14,MIA,29,23070,2
840,4/9/14,MIA,37,23107,2
841,4/11/14,MIA,36,23143,2
842,4/12/14,MIA,27,23170,2
843,10/30/14,CLE,17,23187,2
844,10/31/14,CLE,36,23223,2
845,11/4/14,CLE,11,23234,2
846,11/5/14,CLE,31,23265,2
847,11/7/14,CLE,22,23287,2
848,11/10/14,CLE,32,23319,2
849,11/14/14,CLE,41,23360,2
850,11/15/14,CLE,32,23392,2
851,11/17/14,CLE,22,23414,2
852,11/19/14,CLE,15,23429,2
853,11/21/14,CLE,22,23451,2
854,11/22/14,CLE,15,23466,2
855,11/24/14,CLE,29,23495,2
856,11/26/14,CLE,29,23524,2
857,11/29/14,CLE,19,23543,2
858,12/2/14,CLE,26,23569,2
859,12/4/14,CLE,19,23588,2
860,12/5/14,CLE,24,23612,2
861,12/8/14,CLE,18,23630,2
862,12/9/14,CLE,35,23665,2
863,12/12/14,CLE,41,23706,2
864,12/15/14,CLE,27,23733,2
865,12/17/14,CLE,21,23754,2
866,12/19/14,CLE,22,23776,2
867,12/21/14,CLE,25,23801,2
868,12/23/14,CLE,24,23825,2
869,12/25/14,CLE,30,23855,2
870,12/26/14,CLE,29,23884,2
871,12/28/14,CLE,17,23901,2
872,1/13/15,CLE,33,23934,2
873,1/15/15,CLE,36,23970,2
874,1/16/15,CLE,32,24002,2
875,1/19/15,CLE,26,24028,2
876,1/21/15,CLE,26,24054,2
877,1/23/15,CLE,25,24079,2
878,1/25/15,CLE,34,24113,2
879,1/27/15,CLE,32,24145,2
880,1/30/15,CLE,19,24164,2
881,1/31/15,CLE,36,24200,2
882,2/2/15,CLE,18,24218,2
883,2/5/15,CLE,23,24241,2
884,2/6/15,CLE,25,24266,2
885,2/8/15,CLE,22,24288,2
886,2/11/15,CLE,18,24306,2
887,2/12/15,CLE,31,24337,2
888,2/20/15,CLE,28,24365,2
889,2/22/15,CLE,18,24383,2
890,2/24/15,CLE,19,24402,2
891,2/26/15,CLE,42,24444,2
892,3/1/15,CLE,37,24481,2
893,3/3/15,CLE,27,24508,2
894,3/4/15,CLE,29,24537,2
895,3/6/15,CLE,18,24555,2
896,3/7/15,CLE,17,24572,2
897,3/10/15,CLE,27,24599,2
898,3/12/15,CLE,31,24630,2
899,3/15/15,CLE,21,24651,2
900,3/16/15,CLE,26,24677,2
901,3/18/15,CLE,16,24693,2
902,3/20/15,CLE,29,24722,2
903,3/22/15,CLE,28,24750,2
904,3/25/15,CLE,20,24770,2
905,3/27/15,CLE,24,24794,2
906,3/29/15,CLE,20,24814,2
907,4/2/15,CLE,23,24837,2
908,4/5/15,CLE,20,24857,2
909,4/8/15,CLE,21,24878,2
910,4/10/15,CLE,14,24892,2
911,4/13/15,CLE,21,24913,2
912,10/27/15,CLE,25,24938,2
913,10/28/15,CLE,12,24950,2
914,10/30/15,CLE,29,24979,2
915,11/2/15,CLE,22,25001,2
916,11/4/15,CLE,23,25024,2
917,11/6/15,CLE,31,25055,2
918,11/8/15,CLE,29,25084,2
919,11/10/15,CLE,31,25115,2
920,11/13/15,CLE,31,25146,2
921,11/14/15,CLE,37,25183,2
922,11/17/15,CLE,30,25213,2
923,11/19/15,CLE,27,25240,2
924,11/21/15,CLE,19,25259,2
925,11/23/15,CLE,15,25274,2
926,11/25/15,CLE,24,25298,2
927,11/27/15,CLE,25,25323,2
928,11/28/15,CLE,26,25349,2
929,12/1/15,CLE,24,25373,2
930,12/4/15,CLE,37,25410,2
931,12/8/15,CLE,33,25443,2
932,12/11/15,CLE,25,25468,2
933,12/15/15,CLE,24,25492,2
934,12/17/15,CLE,33,25525,2
935,12/20/15,CLE,23,25548,2
936,12/23/15,CLE,24,25572,2
937,12/25/15,CLE,25,25597,2
938,12/26/15,CLE,12,25609,2
939,12/28/15,CLE,14,25623,2
940,12/29/15,CLE,34,25657,2
941,1/2/16,CLE,29,25686,2
942,1/4/16,CLE,20,25706,2
943,1/6/16,CLE,34,25740,2
944,1/8/16,CLE,13,25753,2
945,1/10/16,CLE,37,25790,2
946,1/12/16,CLE,27,25817,2
947,1/14/16,CLE,22,25839,2
948,1/15/16,CLE,19,25858,2
949,1/18/16,CLE,16,25874,2
950,1/20/16,CLE,17,25891,2
951,1/21/16,CLE,22,25913,2
952,1/23/16,CLE,26,25939,2
953,1/25/16,CLE,25,25964,2
954,1/27/16,CLE,21,25985,2
955,1/29/16,CLE,20,26005,2
956,1/30/16,CLE,29,26034,2
957,2/1/16,CLE,24,26058,2
958,2/3/16,CLE,23,26081,2
959,2/5/16,CLE,30,26111,2
960,2/6/16,CLE,27,26138,2
961,2/8/16,CLE,21,26159,2
962,2/10/16,CLE,29,26188,2
963,2/18/16,CLE,25,26213,2
964,2/21/16,CLE,25,26238,2
965,2/22/16,CLE,12,26250,2
966,2/24/16,CLE,23,26273,2
967,2/26/16,CLE,25,26298,2
968,2/29/16,CLE,33,26331,2
969,3/4/16,CLE,19,26350,2
970,3/5/16,CLE,28,26378,2
971,3/7/16,CLE,28,26406,2
972,3/9/16,CLE,25,26431,2
973,3/10/16,CLE,24,26455,2
974,3/13/16,CLE,27,26482,2
975,3/14/16,CLE,23,26505,2
976,3/18/16,CLE,18,26523,2
977,3/19/16,CLE,26,26549,2
978,3/21/16,CLE,33,26582,2
979,3/23/16,CLE,26,26608,2
980,3/24/16,CLE,30,26638,2
981,3/26/16,CLE,27,26665,2
982,3/31/16,CLE,24,26689,2
983,4/1/16,CLE,29,26718,2
984,4/3/16,CLE,31,26749,2
985,4/5/16,CLE,17,26766,2
986,4/9/16,CLE,33,26799,2
987,4/11/16,CLE,34,26833,2
988,10/25/16,CLE,19,26852,2
989,10/28/16,CLE,21,26873,2
990,10/29/16,CLE,23,26896,2
991,11/1/16,CLE,19,26915,2
992,11/3/16,CLE,30,26945,2
993,11/5/16,CLE,25,26970,2
994,11/8/16,CLE,23,26993,2
995,11/11/16,CLE,27,27020,2
996,11/13/16,CLE,19,27039,2
997,11/15/16,CLE,28,27067,2
998,11/18/16,CLE,21,27088,2
999,11/23/16,CLE,31,27119,2
1000,11/25/16,CLE,19,27138,2
1001,11/27/16,CLE,26,27164,2
1002,11/29/16,CLE,22,27186,2
1003,12/1/16,CLE,16,27202,2
1004,12/2/16,CLE,27,27229,2
1005,12/5/16,CLE,34,27263,2
1006,12/7/16,CLE,25,27288,2
1007,12/9/16,CLE,27,27315,2
1008,12/10/16,CLE,44,27359,2
1009,12/13/16,CLE,23,27382,2
1010,12/17/16,CLE,26,27408,2
1011,12/20/16,CLE,34,27442,2
1012,12/21/16,CLE,29,27471,2
1013,12/23/16,CLE,19,27490,2
1014,12/25/16,CLE,31,27521,2
1015,12/29/16,CLE,23,27544,2
1016,12/31/16,CLE,32,27576,2
1017,1/2/17,CLE,26,27602,2
1018,1/4/17,CLE,31,27633,2
1019,1/6/17,CLE,36,27669,2
1020,1/8/17,CLE,28,27697,2
1021,1/10/17,CLE,29,27726,2
1022,1/11/17,CLE,20,27746,2
1023,1/13/17,CLE,16,27762,2
1024,1/16/17,CLE,20,27782,2
1025,1/19/17,CLE,21,27803,2
1026,1/21/17,CLE,29,27832,2
1027,1/23/17,CLE,26,27858,2
1028,1/25/17,CLE,24,27882,2
1029,1/27/17,CLE,31,27913,2
1030,1/29/17,CLE,25,27938,2
1031,1/30/17,CLE,23,27961,2
1032,2/1/17,CLE,27,27988,2
1033,2/4/17,CLE,32,28020,2
1034,2/6/17,CLE,32,28052,2
1035,2/8/17,CLE,25,28077,2
1036,2/9/17,CLE,18,28095,2
1037,2/11/17,CLE,27,28122,2
1038,2/14/17,CLE,25,28147,2
1039,2/15/17,CLE,31,28178,2
1040,2/23/17,CLE,18,28196,2
1041,2/27/17,CLE,24,28220,2
1042,3/1/17,CLE,28,28248,2
1043,3/3/17,CLE,38,28286,2
1044,3/6/17,CLE,30,28316,2
1045,3/9/17,CLE,29,28345,2
1046,3/11/17,CLE,24,28369,2
1047,3/12/17,CLE,30,28399,2
1048,3/14/17,CLE,16,28415,2
1049,3/16/17,CLE,33,28448,2
1050,3/19/17,CLE,34,28482,2
1051,3/22/17,CLE,18,28500,2
1052,3/24/17,CLE,32,28532,2
1053,3/25/17,CLE,24,28556,2
1054,3/27/17,CLE,17,28573,2
1055,3/30/17,CLE,26,28599,2
1056,3/31/17,CLE,34,28633,2
1057,4/2/17,CLE,41,28674,2
1058,4/4/17,CLE,18,28692,2
1059,4/5/17,CLE,36,28728,2
1060,4/7/17,CLE,27,28755,2
1061,4/9/17,CLE,32,28787,2
1062,10/17/17,CLE,29,28816,3
1063,10/20/17,CLE,24,28840,3
1064,10/21/17,CLE,22,28862,3
1065,10/24/17,CLE,34,28896,3
1066,10/25/17,CLE,29,28925,3
1067,10/28/17,CLE,18,28943,3
1068,10/29/17,CLE,16,28959,3
1069,11/1/17,CLE,33,28992,3
1070,11/3/17,CLE,57,29049,3
1071,11/5/17,CLE,26,29075,3
1072,11/7/17,CLE,30,29105,3
1073,11/9/17,CLE,33,29138,3
1074,11/11/17,CLE,19,29157,3
1075,11/13/17,CLE,23,29180,3
1076,11/15/17,CLE,31,29211,3
1077,11/17/17,CLE,39,29250,3
1078,11/20/17,CLE,18,29268,3
1079,11/22/17,CLE,33,29301,3
1080,11/24/17,CLE,27,29328,3
1081,11/27/17,CLE,30,29358,3
1082,11/28/17,CLE,21,29379,3
1083,11/30/17,CLE,24,29403,3
1084,12/2/17,CLE,34,29437,3
1085,12/4/17,CLE,23,29460,3
1086,12/6/17,CLE,32,29492,3
1087,12/8/17,CLE,29,29521,3
1088,12/9/17,CLE,30,29551,3
1089,12/12/17,CLE,25,29576,3
1090,12/14/17,CLE,25,29601,3
1091,12/16/17,CLE,29,29630,3
1092,12/17/17,CLE,20,29650,3
1093,12/19/17,CLE,39,29689,3
1094,12/21/17,CLE,34,29723,3
1095,12/25/17,CLE,20,29743,3
1096,12/27/17,CLE,16,29759,3
1097,12/30/17,CLE,29,29788,3
1098,1/2/18,CLE,24,29812,3
1099,1/3/18,CLE,19,29831,3
1100,1/6/18,CLE,33,29864,3
1101,1/8/18,CLE,10,29874,3
1102,1/11/18,CLE,26,29900,3
1103,1/12/18,CLE,27,29927,3
1104,1/15/18,CLE,32,29959,3
1105,1/18/18,CLE,16,29975,3
1106,1/20/18,CLE,18,29993,3
1107,1/23/18,CLE,28,30021,3
1108,1/26/18,CLE,26,30047,3
1109,1/28/18,CLE,25,30072,3
1110,1/30/18,CLE,21,30093,3
1111,1/31/18,CLE,24,30117,3
1112,2/3/18,CLE,11,30128,3
1113,2/6/18,CLE,25,30153,3
1114,2/7/18,CLE,37,30190,3
1115,2/9/18,CLE,22,30212,3
1116,2/11/18,CLE,24,30236,3
1117,2/13/18,CLE,37,30273,3
1118,2/22/18,CLE,32,30305,3
1119,2/23/18,CLE,18,30323,3
1120,2/25/18,CLE,33,30356,3
1121,2/27/18,CLE,31,30387,3
1122,3/1/18,CLE,30,30417,3
1123,3/3/18,CLE,25,30442,3
1124,3/5/18,CLE,31,30473,3
1125,3/7/18,CLE,39,30512,3
1126,3/9/18,CLE,25,30537,3
1127,3/11/18,CLE,24,30561,3
1128,3/13/18,CLE,28,30589,3
1129,3/15/18,CLE,35,30624,3
1130,3/17/18,CLE,33,30657,3
1131,3/19/18,CLE,40,30697,3
1132,3/21/18,CLE,35,30732,3
1133,3/23/18,CLE,27,30759,3
1134,3/25/18,CLE,37,30796,3
1135,3/27/18,CLE,18,30814,3
1136,3/28/18,CLE,41,30855,3
1137,3/30/18,CLE,27,30882,3
1138,4/1/18,CLE,16,30898,3
1139,4/3/18,CLE,27,30925,3
1140,4/5/18,CLE,33,30958,3
1141,4/6/18,CLE,44,31002,3
1142,4/9/18,CLE,26,31028,3
1143,4/11/18,CLE,10,31038,3
1144,10/18/18,LAL,26,31064,3
1145,10/20/18,LAL,24,31088,3
1146,10/22/18,LAL,32,31120,3
1147,10/24/18,LAL,19,31139,3
1148,10/25/18,LAL,28,31167,3
1149,10/27/18,LAL,35,31202,3
1150,10/29/18,LAL,29,31231,3
1151,10/31/18,LAL,29,31260,3
1152,11/3/18,LAL,28,31288,3
1153,11/4/18,LAL,18,31306,3
1154,11/7/18,LAL,24,31330,3
1155,11/10/18,LAL,25,31355,3
1156,11/11/18,LAL,26,31381,3
1157,11/14/18,LAL,44,31425,3
1158,11/17/18,LAL,22,31447,3
1159,11/18/18,LAL,51,31498,3
1160,11/21/18,LAL,32,31530,3
1161,11/23/18,LAL,22,31552,3
1162,11/25/18,LAL,24,31576,3
1163,11/27/18,LAL,14,31590,3
1164,11/29/18,LAL,38,31628,3
1165,11/30/18,LAL,28,31656,3
1166,12/2/18,LAL,22,31678,3
1167,12/5/18,LAL,42,31720,3
1168,12/7/18,LAL,35,31755,3
1169,12/8/18,LAL,20,31775,3
1170,12/10/18,LAL,28,31803,3
1171,12/13/18,LAL,29,31832,3
1172,12/15/18,LAL,24,31856,3
1173,12/16/18,LAL,13,31869,3
1174,12/18/18,LAL,36,31905,3
1175,12/21/18,LAL,22,31927,3
1176,12/23/18,LAL,22,31949,3
1177,12/25/18,LAL,17,31966,3
1178,1/31/19,LAL,24,31990,3
1179,2/5/19,LAL,18,32008,3
1180,2/7/19,LAL,28,32036,3
1181,2/10/19,LAL,18,32054,3
1182,2/12/19,LAL,28,32082,3
1183,2/21/19,LAL,29,32111,3
1184,2/23/19,LAL,27,32138,3
1185,2/25/19,LAL,24,32162,3
1186,2/27/19,LAL,33,32195,3
1187,3/1/19,LAL,31,32226,3
1188,3/2/19,LAL,27,32253,3
1189,3/4/19,LAL,27,32280,3
1190,3/6/19,LAL,31,32311,3
1191,3/9/19,LAL,30,32341,3
1192,3/12/19,LAL,36,32377,3
1193,3/14/19,LAL,29,32406,3
1194,3/17/19,LAL,33,32439,3
1195,3/22/19,LAL,25,32464,3
1196,3/24/19,LAL,29,32493,3
1197,3/26/19,LAL,23,32516,3
1198,3/29/19,LAL,27,32543,3
1199,10/22/19,LAL,18,32561,3
1200,10/25/19,LAL,32,32593,3
1201,10/27/19,LAL,20,32613,3
1202,10/29/19,LAL,23,32636,3
1203,11/1/19,LAL,39,32675,3
1204,11/3/19,LAL,21,32696,3
1205,11/5/19,LAL,30,32726,3
1206,11/8/19,LAL,25,32751,3
1207,11/10/19,LAL,13,32764,3
1208,11/12/19,LAL,19,32783,3
1209,11/13/19,LAL,23,32806,3
1210,11/15/19,LAL,29,32835,3
1211,11/17/19,LAL,33,32868,3
1212,11/19/19,LAL,25,32893,3
1213,11/22/19,LAL,23,32916,3
1214,11/23/19,LAL,30,32946,3
1215,11/25/19,LAL,33,32979,3
1216,11/27/19,LAL,29,33008,3
1217,11/29/19,LAL,23,33031,3
1218,12/1/19,LAL,25,33056,3
1219,12/3/19,LAL,25,33081,3
1220,12/4/19,LAL,20,33101,3
1221,12/6/19,LAL,31,33132,3
1222,12/8/19,LAL,32,33164,3
1223,12/11/19,LAL,25,33189,3
1224,12/13/19,LAL,28,33217,3
1225,12/15/19,LAL,32,33249,3
1226,12/17/19,LAL,20,33269,3
1227,12/19/19,LAL,21,33290,3
1228,12/25/19,LAL,23,33313,3
1229,12/28/19,LAL,21,33334,3
1230,12/29/19,LAL,13,33347,3
1231,1/1/20,LAL,31,33378,3
1232,1/3/20,LAL,17,33395,3
1233,1/5/20,LAL,21,33416,3
1234,1/7/20,LAL,31,33447,3
1235,1/10/20,LAL,35,33482,3
1236,1/13/20,LAL,31,33513,3
1237,1/15/20,LAL,19,33532,3
1238,1/18/20,LAL,31,33563,3
1239,1/20/20,LAL,15,33578,3
1240,1/22/20,LAL,21,33599,3
1241,1/23/20,LAL,27,33626,3
1242,1/25/20,LAL,29,33655,3
1243,1/31/20,LAL,22,33677,3
1244,2/1/20,LAL,15,33692,3
1245,2/4/20,LAL,36,33728,3
1246,2/6/20,LAL,18,33746,3
1247,2/8/20,LAL,22,33768,3
1248,2/10/20,LAL,17,33785,3
1249,2/12/20,LAL,32,33817,3
1250,2/21/20,LAL,32,33849,3
1251,2/23/20,LAL,29,33878,3
1252,2/25/20,LAL,40,33918,3
1253,2/29/20,LAL,19,33937,3
1254,3/1/20,LAL,34,33971,3
1255,3/3/20,LAL,22,33993,3
1256,3/6/20,LAL,37,34030,3
1257,3/8/20,LAL,28,34058,3
1258,3/10/20,LAL,29,34087,3
1259,7/30/20,LAL,16,34103,3
1260,8/1/20,LAL,20,34123,3
1261,8/3/20,LAL,22,34145,3
1262,8/5/20,LAL,19,34164,3
1263,8/8/20,LAL,31,34195,3
1264,8/10/20,LAL,29,34224,3
1265,8/13/20,LAL,17,34241,3
1266,12/22/20,LAL,22,34263,4
1267,12/25/20,LAL,22,34285,4
1268,12/27/20,LAL,18,34303,4
1269,12/28/20,LAL,29,34332,4
1270,12/30/20,LAL,26,34358,4
1271,1/1/21,LAL,26,34384,4
1272,1/3/21,LAL,22,34406,4
1273,1/5/21,LAL,26,34432,4
1274,1/7/21,LAL,27,34459,4
1275,1/8/21,LAL,28,34487,4
1276,1/10/21,LAL,18,34505,4
1277,1/12/21,LAL,26,34531,4
1278,1/13/21,LAL,26,34557,4
1279,1/15/21,LAL,21,34578,4
1280,1/18/21,LAL,19,34597,4
1281,1/21/21,LAL,34,34631,4
1282,1/23/21,LAL,17,34648,4
1283,1/25/21,LAL,46,34694,4
1284,1/27/21,LAL,34,34728,4
1285,1/28/21,LAL,22,34750,4
1286,1/30/21,LAL,21,34771,4
1287,2/1/21,LAL,21,34792,4
1288,2/4/21,LAL,27,34819,4
1289,2/6/21,LAL,33,34852,4
1290,2/8/21,LAL,28,34880,4
1291,2/10/21,LAL,25,34905,4
1292,2/12/21,LAL,28,34933,4
1293,2/14/21,LAL,22,34955,4
1294,2/16/21,LAL,30,34985,4
1295,2/18/21,LAL,32,35017,4
1296,2/20/21,LAL,19,35036,4
1297,2/22/21,LAL,31,35067,4
1298,2/24/21,LAL,19,35086,4
1299,2/26/21,LAL,28,35114,4
1300,2/28/21,LAL,19,35133,4
1301,3/2/21,LAL,38,35171,4
1302,3/12/21,LAL,18,35189,4
1303,3/15/21,LAL,22,35211,4
1304,3/16/21,LAL,25,35236,4
1305,3/18/21,LAL,37,35273,4
1306,3/20/21,LAL,10,35283,4
1307,4/30/21,LAL,16,35299,4
1308,5/2/21,LAL,19,35318,4
1309,5/15/21,LAL,24,35342,4
1310,5/16/21,LAL,25,35367,4
1311,10/19/21,LAL,34,35401,4
1312,10/22/21,LAL,25,35426,4
1313,10/24/21,LAL,19,35445,4
1314,10/29/21,LAL,26,35471,4
1315,10/31/21,LAL,15,35486,4
1316,11/2/21,LAL,30,35516,4
1317,11/19/21,LAL,23,35539,4
1318,11/21/21,LAL,10,35549,4
1319,11/24/21,LAL,39,35588,4
1320,11/26/21,LAL,30,35618,4
1321,11/28/21,LAL,33,35651,4
1322,12/3/21,LAL,23,35674,4
1323,12/7/21,LAL,30,35704,4
1324,12/9/21,LAL,20,35724,4
1325,12/10/21,LAL,33,35757,4
1326,12/12/21,LAL,30,35787,4
1327,12/15/21,LAL,24,35811,4
1328,12/17/21,LAL,18,35829,4
1329,12/19/21,LAL,31,35860,4
1330,12/21/21,LAL,34,35894,4
1331,12/23/21,LAL,36,35930,4
1332,12/25/21,LAL,39,35969,4
1333,12/28/21,LAL,32,36001,4
1334,12/29/21,LAL,37,36038,4
1335,12/31/21,LAL,43,36081,4
1336,1/2/22,LAL,26,36107,4
1337,1/4/22,LAL,31,36138,4
1338,1/7/22,LAL,32,36170,4
1339,1/9/22,LAL,35,36205,4
1340,1/12/22,LAL,34,36239,4
1341,1/15/22,LAL,25,36264,4
1342,1/17/22,LAL,25,36289,4
1343,1/19/22,LAL,30,36319,4
1344,1/21/22,LAL,29,36348,4
1345,1/23/22,LAL,33,36381,4
1346,1/25/22,LAL,33,36414,4
1347,2/5/22,LAL,29,36443,4
1348,2/8/22,LAL,27,36470,4
1349,2/9/22,LAL,30,36500,4
1350,2/12/22,LAL,26,36526,4
1351,2/16/22,LAL,33,36559,4
1352,2/25/22,LAL,21,36580,4
1353,2/27/22,LAL,32,36612,4
1354,3/1/22,LAL,26,36638,4
1355,3/3/22,LAL,26,36664,4
1356,3/5/22,LAL,56,36720,4
1357,3/9/22,LAL,23,36743,4
1358,3/11/22,LAL,50,36793,4
1359,3/13/22,LAL,31,36824,4
1360,3/14/22,LAL,30,36854,4
1361,3/16/22,LAL,19,36873,4
1362,3/18/22,LAL,36,36909,4
1363,3/19/22,LAL,38,36947,4
1364,3/21/22,LAL,38,36985,4
1365,3/27/22,LAL,39,37024,4
1366,4/1/22,LAL,38,37062,4
1367,10/18/22,LAL,31,37093,4
1368,10/20/22,LAL,20,37113,4
1369,10/23/22,LAL,31,37144,4
1370,10/26/22,LAL,19,37163,4
1371,10/28/22,LAL,28,37191,4
1372,10/30/22,LAL,26,37217,4
1373,11/2/22,LAL,20,37237,4
1374,11/4/22,LAL,17,37254,4
1375,11/6/22,LAL,27,37281,4
1376,11/9/22,LAL,30,37311,4
1377,11/25/22,LAL,21,37332,4
1378,11/26/22,LAL,39,37371,4
1379,11/28/22,LAL,21,37392,4
1380,11/30/22,LAL,31,37423,4
1381,12/2/22,LAL,28,37451,4
1382,12/4/22,LAL,29,37480,4
1383,12/6/22,LAL,21,37501,4
1384,12/9/22,LAL,23,37524,4
1385,12/11/22,LAL,35,37559,4
1386,12/13/22,LAL,33,37592,4
1387,12/16/22,LAL,30,37622,4
1388,12/18/22,LAL,33,37655,4
1389,12/21/22,LAL,31,37686,4
1390,12/23/22,LAL,34,37720,4
1391,12/25/22,LAL,38,37758,4
1392,12/27/22,LAL,28,37786,4
1393,12/28/22,LAL,27,37813,4
1394,12/30/22,LAL,47,37860,4
1395,1/2/23,LAL,43,37903,4
1396,1/6/23,LAL,25,37928,4
1397,1/7/23,LAL,37,37965,4
1398,1/12/23,LAL,24,37989,4
1399,1/15/23,LAL,35,38024,4
1400,1/16/23,LAL,48,38072,4
1401,1/18/23,LAL,32,38104,4
1402,1/20/23,LAL,23,38127,4
1403,1/22/23,LAL,37,38164,4
1404,1/24/23,LAL,46,38210,4
1405,1/25/23,LAL,20,38230,4
1406,1/28/23,LAL,41,38271,4
1407,1/31/23,LAL,28,38299,4